90000044400000000009
00000700000000000000
00000000000000040000
00000000000000040000
00000000000000040000
00000000000000040000
00000000008000000000
00000044444444400000
00000000000000000000
90000000000000000009