90000000000000000009
00000000000000000000
00000444444444400000
00207000000000000200
00200000000000000200
00208000000000000200
00200444444444400200
00200000000000000200
00000000000000000000
90000000000000000009