90000000000000000009
00000000000000000000
00000333344444400000
00007000000000000000
00000000000000000000
00800000000000000000
00000444443334400000
00000000000000000000
00000000000000000000
90000000000000000009