90000000000000000009
00000000000000000000
00000444444444400000
00107000000000000100
00100000000000000100
00108000000000000100
00100444444444400100
00100000000000000100
00000000000000000000
90000000000000000009