90000044400000000009
00000700000000000000
00000000000040000000
00000000000040000000
00000000000040000000
00444400000040000000
00000044444444400000
00000000000000000000
00000000000044444000
90000000000000000009