90000000000000000009
00000700000000000000
00000000000000000000
00000400000000400000
00000040000000040000
00800004000000004000
00000000400000000400
00000000040000000000
00000000000000000000
90000000000000000009