90020000000000002009
00020000000000002002
00000444444444400000
00007000000000000000
00000000000000000000
00000444444444400000
00000200020000200000
00020000000000200000
00000222220000200000
90000000002200000009