90000000000000000009
00000000000000000000
00000444444444400000
00107000000000000300
00100000000000000300
00108000000000000300
00100444443334400400
00100000000000000300
00000000000000000000
90000000000000000009